key	text	tooltip
#Loc;1;text/db/vco_custom_landmarks.loc		
building_culture_variants_name_vco_landmark_fozzriks_flying_fastness	Fozzrik's Flying Fortress	false
building_culture_variants_name_vco_landmark_fozzriks_flying_fastnesswh2_dlc09_skv_clan_rictus	Fozzrik's Flying Fortress	false
building_chains_chain_tooltip_vco_landmark_fozzriks_flying_fastness	Marvel of the Badlands	false
building_short_description_texts_short_description_vco_landmark_fozzriks_flying_fastness	A castle as large as any in Bretonnia and crowned by eight spires swirling with all the Winds of Magic, the Flying Fortress would be a marvel even if it was grounded.	false
building_culture_variants_name_vco_landmark_grombrindal_shattered_malekith_tower	Ruined Black Tower of Malekith	false
building_culture_variants_name_vco_landmark_grombrindal_shattered_malekith_towerwh3_main_dwf_the_ancestral_throng	Ruined Black Tower of Malekith	false
building_chains_chain_tooltip_vco_landmark_grombrindal_shattered_malekith_tower	Legendary Palace	false
building_short_description_texts_short_description_vco_landmark_grombrindal_shattered_malekith_tower	From out of the mountains they came, a throng of vengeful dwarfs with the White Dwarf at their head. With hammer and shield, they brought the elves to ruin.	false
building_culture_variants_name_vco_landmark_grombrindal_vauls_anvil	Vaul's Anvil	false
building_culture_variants_name_vco_landmark_grombrindal_vauls_anvilwh3_main_dwf_the_ancestral_throng	Vaul's Anvil	false
building_chains_chain_tooltip_vco_landmark_grombrindal_vauls_anvil	Arcane Armoury	false
building_short_description_texts_short_description_vco_landmark_grombrindal_vauls_anvil	With the Hammer of Vaul the Runesmiths wrought miracles in stone and steel.	false
building_culture_variants_name_vco_landmark_grombrindal_vauls_anvil_caledor	Vaul's Anvil	false
building_culture_variants_name_vco_landmark_grombrindal_vauls_anvil_caledorwh3_main_dwf_the_ancestral_throng	Vaul's Anvil	false
building_chains_chain_tooltip_vco_landmark_grombrindal_vauls_anvil_caledor	The Volcanic Forge	false
building_short_description_texts_short_description_vco_landmark_grombrindal_vauls_anvil_caledor	Within the Shrine of Vaul the Runesmiths labour, while Slayers journey across the ocean to hunt the last dragons of Ulthuan.	false
building_culture_variants_name_vco_landmark_grombrindal_repurposed_docks	Repurposed Docks	false
building_culture_variants_name_vco_landmark_grombrindal_repurposed_dockswh3_main_dwf_the_ancestral_throng	Repurposed Docks	false
building_chains_chain_tooltip_vco_landmark_grombrindal_repurposed_docks	Reformed City	false
building_short_description_texts_short_description_vco_landmark_grombrindal_repurposed_docks	Slavers Gate, now liberated from the hateful elves, has been repurposed into a bustling port city, a safe harbour for ships bringing in supplies and reinforcements from Barak Varr.	false
building_culture_variants_name_vco_landmark_mazdamundi_geomantic_nexus	Geomantic Nexus	false
building_culture_variants_name_vco_landmark_mazdamundi_geomantic_nexuswh2_main_lzd_hexoatl	Geomantic Nexus	false
building_chains_chain_tooltip_vco_landmark_mazdamundi_geomantic_nexus	Locus of Power	false
building_short_description_texts_short_description_vco_landmark_mazdamundi_geomantic_nexus	Grand edifices built atop the convergences of ley lines amplify the magics of the Slann Mage-Priests manyfold.	false
building_culture_variants_name_vco_landmark_zhao_warpforges	Warpforges	false
building_culture_variants_name_vco_landmark_zhao_warpforgeswh3_main_cth_the_western_provinces	Warpforges	false
building_chains_chain_tooltip_vco_landmark_zhao_warpforges	Warpstone Hoard	false
building_short_description_texts_short_description_vco_landmark_zhao_warpforges	Mixing powdered Warpstone with steel during the forging process creates weapons of wicked cutting prowess.	false
building_culture_variants_name_vco_landmark_zhao_sigmars_rock	Sigmar's Rock	false
building_culture_variants_name_vco_landmark_zhao_sigmars_rockwh3_main_cth_the_western_provinces	Sigmar's Rock	false
building_chains_chain_tooltip_vco_landmark_zhao_sigmars_rock	Warpstone Hoard	false
building_short_description_texts_short_description_vco_landmark_zhao_sigmars_rock	The Order of Merciful Sisters of Sigmar dedicate their lives to recovering Warpstone from across the world and bringing it to Sigmar's Rock for safekeeping. The Iron Dragon thanks them for their service.	false
building_culture_variants_name_vco_landmark_kostaltyn_sacred_flame_ulric	Sacred Flame of Ulric	false
building_culture_variants_name_vco_landmark_kostaltyn_sacred_flame_ulricwh3_main_ksl_the_great_orthodoxy	Sacred Flame of Ulric	false
building_chains_chain_tooltip_vco_landmark_kostaltyn_sacred_flame_ulric	Ulricsberg Landmark	false
building_short_description_texts_short_description_vco_landmark_kostaltyn_sacred_flame_ulric	When Kostaltyn emerged unscathed from the Trial of the Flame, all knew he had the Wolf-God's blessing.	false
building_culture_variants_name_vco_landmark_kostaltyn_great_orthodoxy_cathedral	Great Orthodoxy Cathedral	false
building_culture_variants_name_vco_landmark_kostaltyn_great_orthodoxy_cathedralwh3_main_ksl_the_great_orthodoxy	Great Orthodoxy Cathedral	false
building_chains_chain_tooltip_vco_landmark_kostaltyn_great_orthodoxy_cathedral	Triumph of Faith	false
building_short_description_texts_short_description_vco_landmark_kostaltyn_great_orthodoxy_cathedral	The great domed Cathedral of Sigmar now stands humbly as one among many that dominate Altdorf's skyline, symbolising the triumph of a new faith.	false
building_culture_variants_name_vco_landmark_kostaltyn_dazhs_everburning_pyres	Dazh's Everburning Pyres	false
building_culture_variants_name_vco_landmark_kostaltyn_dazhs_everburning_pyreswh3_main_ksl_the_great_orthodoxy	Dazh's Everburning Pyres	false
building_chains_chain_tooltip_vco_landmark_kostaltyn_dazhs_everburning_pyres	The Cleansing Flames	false
building_short_description_texts_short_description_vco_landmark_kostaltyn_dazhs_everburning_pyres	The charred remains of Sylvania's counts are displayed as a warning to both commoner and noble alike: none may challenge the Great Orthodoxy.	false
building_culture_variants_name_vco_landmark_wulfhart_lumber_yard	Lumber Yard	false
building_culture_variants_name_vco_landmark_wulfhart_lumber_yardwh2_dlc13_emp_the_huntmarshals_expedition	Lumber Yard	false
building_chains_chain_tooltip_vco_landmark_wulfhart_lumber_yard	The Sacred Stumps	false
building_short_description_texts_short_description_vco_landmark_wulfhart_lumber_yard	Vast swathes of deforested fields stand testament to man's triumph over these wild lands.	false
building_culture_variants_name_vco_landmark_wulfhart_imperial_dockyard	Imperial Dockyard	false
building_culture_variants_name_vco_landmark_wulfhart_imperial_dockyardwh2_dlc13_emp_the_huntmarshals_expedition	Imperial Dockyard	false
building_chains_chain_tooltip_vco_landmark_wulfhart_imperial_dockyard	Cleansed Coast	false
building_short_description_texts_short_description_vco_landmark_wulfhart_imperial_dockyard	With Harkon's pirates no longer threatening Imperial shipping lanes, the Huntsmarshal's expedition can receive more shipments from the mainland.	false
building_culture_variants_name_vco_landmark_markus_trophy_hall	Trophy Hall	false
building_culture_variants_name_vco_landmark_markus_trophy_hallwh2_dlc13_emp_the_huntmarshals_expedition	Trophy Hall	false
building_chains_chain_tooltip_vco_landmark_markus_trophy_hall	Conquered Temple-City	false
building_short_description_texts_short_description_vco_landmark_markus_trophy_hall	Here, the Huntsmarshal's impressive collection of hunting trophies are on display, a testament to the expedition's continued success in the hazardous jungles of Lustria.	false
building_culture_variants_name_vco_landmark_imrik_blessed_incubator	Blessed Incubator	false
building_culture_variants_name_vco_landmark_imrik_blessed_incubatorwh2_dlc15_hef_imrik	Blessed Incubator	false
building_chains_chain_tooltip_vco_landmark_imrik_blessed_incubator	Hexoatl Landmark	false
building_short_description_texts_short_description_vco_landmark_imrik_blessed_incubator	The esoteric creations of the Old Ones once drove the dragons into dormancy. Now, with the Elves' guidance, they will bring about the next generation of dragons.	false
building_culture_variants_name_vco_landmark_imrik_asrai_enclave	The Verdant Glade	false
building_culture_variants_name_vco_landmark_imrik_asrai_enclavewh2_dlc15_hef_imrik	The Verdant Glade	false
building_chains_chain_tooltip_vco_landmark_imrik_asrai_enclave	Asrai Enclave	false
building_short_description_texts_short_description_vco_landmark_imrik_asrai_enclave	Spellsingers from Athel Loren have begun the arduous task of cleansing this tainted forest.	false
building_culture_variants_name_vco_landmark_tretch_tower_gorgoth	The Tower of Gorgoth	false
building_culture_variants_name_vco_landmark_tretch_tower_gorgothwh2_dlc09_skv_clan_rictus	The Tower of Gorgoth	false
building_chains_chain_tooltip_vco_landmark_tretch_tower_gorgoth	Conquered Fortress	false
building_short_description_texts_short_description_vco_landmark_tretch_tower_gorgoth	The Grey Seers have erected a crude device at the tower's highest point. It throbs with a sickly green glow.	false
building_culture_variants_name_vco_landmark_grombrindal_vauls_anvil_athel_loren	Vaul's Anvil	false
building_culture_variants_name_vco_landmark_grombrindal_vauls_anvil_athel_lorenwh3_main_dwf_the_ancestral_throng	Vaul's Anvil	false
building_chains_chain_tooltip_vco_landmark_grombrindal_vauls_anvil_athel_loren	The Starlight Forge	false
building_short_description_texts_short_description_vco_landmark_grombrindal_vauls_anvil_athel_loren	Though the Dwarfs usually consider Elven craftsmanship shoddy at best, even they had to begrudgingly admit that the Starlight Forge was of peerless design.\\n	false
building_culture_variants_name_vco_landmark_sisters_twilight_vauls_anvil_naggaroth	Vaul's Anvil	false
building_culture_variants_name_vco_landmark_sisters_twilight_vauls_anvil_naggarothwh2_dlc16_wef_sisters_of_twilight	Vaul's Anvil	false
building_chains_chain_tooltip_vco_landmark_sisters_twilight_vauls_anvil_naggaroth	Arcane Armoury	false
building_short_description_texts_short_description_vco_landmark_sisters_twilight_vauls_anvil_naggaroth	Though the Hammer of Vaul radiates with an ancient, godly power, Lord Daith wields it with effortless grace.	false
building_culture_variants_name_vco_landmark_sisters_twilight_vauls_anvil_caledor	Vaul's Anvil	false
building_culture_variants_name_vco_landmark_sisters_twilight_vauls_anvil_caledorwh2_dlc16_wef_sisters_of_twilight	Vaul's Anvil	false
building_chains_chain_tooltip_vco_landmark_sisters_twilight_vauls_anvil_caledor	The Volcanic Forge	false
building_short_description_texts_short_description_vco_landmark_sisters_twilight_vauls_anvil_caledor	Within the great shrine of Vaul, Daith wields the fires of the very earth itself to craft weapons of peerless quality.	false
building_culture_variants_name_vco_landmark_kostaltyn_halls_of_atonement	The Halls of Atonement	false
building_culture_variants_name_vco_landmark_kostaltyn_halls_of_atonementwh3_main_ksl_the_great_orthodoxy	The Halls of Atonement	false
building_chains_chain_tooltip_vco_landmark_kostaltyn_halls_of_atonement	Marienburg Landmark	false
building_short_description_texts_short_description_vco_landmark_kostaltyn_halls_of_atonement	The burgomeisters have forsaken Handrich and embraced the Great Orthodoxy. Here they sell indulgences to those seeking remission for their sins in the next life.	false
building_culture_variants_name_vco_landmark_karl_franz_marienburg_tax_house	Imperial Tax House	false
building_culture_variants_name_vco_landmark_karl_franz_marienburg_tax_housewh_main_emp_empire	Imperial Tax House	false
building_chains_chain_tooltip_vco_landmark_karl_franz_marienburg_tax_house	Marienburg Landmark	false
building_short_description_texts_short_description_vco_landmark_karl_franz_marienburg_tax_house	The burgomeisters have A LOT of unpaid taxesâ€¦	false
building_culture_variants_name_vco_landmark_karl_franz_lumber_yard	Lumber Yard	false
building_culture_variants_name_vco_landmark_karl_franz_lumber_yardwh_main_emp_empire	Lumber Yard	false
building_chains_chain_tooltip_vco_landmark_karl_franz_lumber_yard	Sanctified Woods	false
building_short_description_texts_short_description_vco_landmark_karl_franz_lumber_yard	The fell spirits that once haunted this wood have been driven back by faith, steel and gunpowder. Local lumberjacks have since capitalised on the situation.	false
building_culture_variants_name_vco_landmark_skrag_great_maw_2	The Maelstrom	false
building_culture_variants_name_vco_landmark_skrag_great_maw_2wh3_main_ogr_disciples_of_the_maw	The Maelstrom	false
building_chains_chain_tooltip_vco_landmark_skrag_great_maw_2	Maw of the Ocean	false
building_short_description_texts_short_description_vco_landmark_skrag_great_maw_2	Great, another mouth to feed!	false
building_culture_variants_name_vco_landmark_skrag_couronne_cook_pot	The Couronne Cookpot	false
building_culture_variants_name_vco_landmark_skrag_couronne_cook_potwh3_main_ogr_disciples_of_the_maw	The Couronne Cookpot	false
building_chains_chain_tooltip_vco_landmark_skrag_couronne_cook_pot	Conquered Bretonnian Capital	false
building_short_description_texts_short_description_vco_landmark_skrag_couronne_cook_pot	The Slaughterer has erected a great cookpot in the centre of the Couronne tourney grounds. Ogres from many tribes journey to his newfound kingdom to participate in his frequent Great Feasts.	false
building_culture_variants_name_vco_landmark_kemmler_couronne_corpse_king	Throne of the Corpse King	false
building_culture_variants_name_vco_landmark_kemmler_couronne_corpse_kingwh2_dlc11_vmp_the_barrow_legion	Throne of the Corpse King	false
building_chains_chain_tooltip_vco_landmark_kemmler_couronne_corpse_king	Subjugated Bretonnian Capital	false
building_short_description_texts_short_description_vco_landmark_kemmler_couronne_corpse_king	Couronne's Royarch rules the Bretonnians with an iron fist. It is said he never sleeps, never eats, and never removes his armour - such is his dedication to his people.	false
building_culture_variants_name_vco_landmark_kemmler_treeman_graveyard	Blightwood	false
building_culture_variants_name_vco_landmark_kemmler_treeman_graveyardwh2_dlc11_vmp_the_barrow_legion	Blightwood	false
building_chains_chain_tooltip_vco_landmark_kemmler_treeman_graveyard	Field of Ruin	false
building_short_description_texts_short_description_vco_landmark_kemmler_treeman_graveyard	The withered husks of many Treemen stand testament to the Lichemaster's victory at Argwylon.	false
building_culture_variants_name_vco_landmark_karl_franz_cleansing_pyres	Witch Hunter Barracks	false
building_culture_variants_name_vco_landmark_karl_franz_cleansing_pyreswh_main_emp_empire	Witch Hunter Barracks	false
building_chains_chain_tooltip_vco_landmark_karl_franz_cleansing_pyres	Cleansed Castle	false
building_short_description_texts_short_description_vco_landmark_karl_franz_cleansing_pyres	The Witch Hunters rounded up the blood-hungry nobles who once lorded over these lands and burned them all at the stake. Their constant vigilance is required to ensure Sylvania does not sink back into depravity.	false
