key	text	tooltip
#Loc;1;text/db/vco_custom_ancillaries.loc		
ancillaries_colour_text_vco_anc_arcane_item_cube_of_darkness	Found in the metal ark beneath Xhotl, the Cube of Darkness is as alien as it is powerful. Viewed up close, this small black cube contains millions of tiny pin-pricks of blinking light, each circling a sphere of pure darkness. By implementing the correct pattern of thoughts, the cube may be opened for a fraction of a second, inexpleciably drawing the very Winds of Magic into its depths.	true
ancillaries_colour_text_vco_anc_enchanted_item_the_crown_of_sorcery	The Crown's whispered advice lured Azhag into an ambush whereupon he was slain by Arkhan the Black, greatest of Nagash's servants. With the Crown now in his possession, the Great Necromancer's return is imminent.	true
ancillaries_colour_text_vco_anc_magic_standard_shroud_of_gilles	This holy relic still bears the image of the Bretonnian hero's body, imprinted with his blood when he was mortally wounded. The Cultists of Tzeentch now use this sacred blood of the slain hero in their profane rituals.	true
ancillaries_colour_text_vco_anc_weapon_ghal_maraz	Ghal Maraz is the legendary hammer of Sigmar and one of the most potent magical artefacts in the entire world. This rune-encrusted weapon has been the symbol of the Emperor's office ever since the founding of the Empire.	true
ancillaries_colour_text_vco_anc_enchanted_item_hand_of_gods	This ancient artifact of the Old Ones was once wielded by the legendary Saurus Kroq-Gar, before his defeat at the hands of Kairos Fateweaver. It has been repurposed into a weapon of dread power.	true
ancillaries_colour_text_vco_anc_weapon_the_blade_of_realities	Brought to the world by the Old Ones, this weapon shimmers with unnatural power. Legends carved on ancient stone claim the blade exists on every plane of reality simultaneously, and that its edge can sever a creature's soul. No earthly force can stop this deadly blade - it penetrates granite and steel as easily as it slices through flesh and bone.	true
ancillaries_colour_text_vco_anc_weapon_the_heartwood_lance	This lance was crafted from the heart of the Major Oak, the largest tree in Bretonnia, which was shattered by lightning the moment Gilles was struck down. Its blackened wood is covered with tiny carvings depicting the twelve battles of Gilles and, despite being harder than stone and diamond sharp, it is lightweight and beautiful to behold.	true
ancillaries_onscreen_name_vco_anc_arcane_item_cube_of_darkness	Cube of Darkness	true
ancillaries_onscreen_name_vco_anc_enchanted_item_the_crown_of_sorcery	The Crown of Sorcery	true
ancillaries_onscreen_name_vco_anc_magic_standard_shroud_of_gilles	The Shroud of Gilles le Breton	true
ancillaries_onscreen_name_vco_anc_weapon_ghal_maraz	Ghal Maraz	true
ancillaries_onscreen_name_vco_anc_enchanted_item_hand_of_gods	Repurposed Hand of Gods	true
ancillaries_onscreen_name_vco_anc_weapon_the_blade_of_realities	The Blade of Realities	true
ancillaries_onscreen_name_vco_anc_weapon_the_heartwood_lance	The Heartwood Lance	true
ancillaries_onscreen_name_vco_anc_weapon_scourge	Scourge	true
ancillaries_onscreen_name_vco_anc_weapon_the_sword_of_couronne	Profaned Sword of Couronne	true
ancillaries_onscreen_name_vco_anc_enchanted_item_moonstone	Moonstone of the Hidden Ways	true
ancillaries_onscreen_name_vco_anc_arcane_item_mirror_of_the_ice_queen	Mirror of the Ice Queen	true
ancillaries_colour_text_vco_anc_weapon_scourge	Scourge is a lethal whip, thirsty for blood and wrapped in the bitter curses of many generations of Bray-Shamans. 	true
ancillaries_colour_text_vco_anc_weapon_the_sword_of_couronne	This powerful heirloom was forged from the finest Bretonnian siverline. It catches the sun's rays and magnifies them, dazzling the foe as the wielder makes their death stroke. It is now stained with the golden blood of Bretonnia's Royarch.	true
ancillaries_colour_text_vco_anc_enchanted_item_moonstone	In ages past, the worldroots linked Athel Loren not only with every forest upon the face of the world, but those further afield also. Much has changed since those days. Many pathways are now forever closed, and those that remain can be unsealed only through the use of this ancient Moonstone.	true
ancillaries_colour_text_vco_anc_arcane_item_mirror_of_the_ice_queen	A hand mirror fashioned from flawless ice and bound within an intricate frame of frostwork. A gift from the Ice Queen to Azazel, so that he can gaze upon his beautiful form whenever he deems fit.	true
ancillaries_onscreen_name_vco_anc_weapon_blade_of_corruption	Blade of Corruption	true
ancillaries_colour_text_vco_anc_weapon_blade_of_corruption	This sword was left for 13 days in the dreaded Cauldron of a Thousand Poxes before it was presented to the Leechlord as a gesture of peace from Clan Pestilens.	true
ancillaries_onscreen_name_vco_anc_arcane_item_warp_scroll	Warp Scroll	true
ancillaries_colour_text_vco_anc_arcane_item_warp_scroll	This copied magical script outlines techniques from the great Liber Bubonicus. It has been written in warpstone ink on flayed hides of those unable to withstand the Great Horned Rat's gifts.	true
ancillaries_onscreen_name_vco_anc_arcane_item_yueyins_diamond	Yueyin's Diamond	true
ancillaries_colour_text_vco_anc_arcane_item_yueyins_diamond	This brilliant crystal shines with the light of the true moon itself. Its touch is anaethama to daemons, and even to stare upon it is to risk banishment back to the Realms of Chaos.	true
ancillaries_onscreen_name_vco_anc_enchanted_item_the_rock_of_inevitability	The Rock of Inevitability	true
ancillaries_colour_text_vco_anc_enchanted_item_the_rock_of_inevitability	Deep in the Realm of Chaos sits the Inevitable City. It is an ageless edifice that lies ever distant from those who seek to reach it, and shadows every step taken by those who wish to escape it. The city has been destroyed many times, but has always rebuilt itself - and always will so long as a single stone remains. Indeed, if but one worn brick from its walls is planted in the mortal realm, it is said that a new city will soon arise.	true
ancillaries_onscreen_name_vco_anc_weapon_witstealer_sword	Witstealer Sword	true
ancillaries_colour_text_vco_anc_weapon_witstealer_sword	Forged in the molten heat of desire and cooled in a vat of Slaanesh's own blood, the Witstealer Sword was presented to the Arch-tempter by the Dark Prince himself.	true
ancillaries_onscreen_name_vco_anc_weapon_sliverslash	Sliverslash	true
ancillaries_colour_text_vco_anc_weapon_sliverslash	It is said Prince Sigvald's ornate sword is forged from a sliver of Slaanesh's own blade. It moves like quicksilver, striking its foes down in a flurry of lightning-quick blows.	true
ancillaries_onscreen_name_vco_anc_weapon_warpsword_of_khaine	The Warpsword of Khaine	true
ancillaries_colour_text_vco_anc_weapon_warpsword_of_khaine	"The Time of Blood is at hand!"	true
ancillaries_onscreen_name_vco_anc_talisman_superior_collar_of_khorne	Superior Collar of Khorne	true
ancillaries_colour_text_vco_anc_talisman_superior_collar_of_khorne	Valkia's hellsmiths have used the blood of the slain Ice Witches to create a uniquely superior Collar of Khorne. This rune-etched brass collar will protect the wearer from all but the most grevious of magical attacks.	true
ancillaries_onscreen_name_vco_anc_weapon_the_slayer_of_kings	The Slayer of Kings	true
ancillaries_colour_text_vco_anc_weapon_the_slayer_of_kings	The Second Everchosen, Vangel, trapped the Greater Daemon U'zuhl inside this regicidal blade. Aeons of imprisonment inside the blade has driven the Daemon insane with rage. In battle, the blade moans with barely contained fury.	true
ancillaries_onscreen_name_vco_anc_armour_the_armour_of_morkar	The Armour of Morkar	true
ancillaries_colour_text_vco_anc_armour_the_armour_of_morkar	Once belonging to the First Everchosen of Chaos, this ancient suit of Chaos Armour is as powerful as those who have dared to wear it.	true
ancillaries_onscreen_name_vco_anc_talisman_the_eye_of_sheerian	The Eye of Sheerian	true
ancillaries_colour_text_vco_anc_talisman_the_eye_of_sheerian	Named after the Tzeentchian Sorcerer who discovered it, the Eye sees nearly all. Its current owner should make use of its prophetic powers...	true
ancillaries_onscreen_name_vco_anc_enchanted_item_black_dragon_egg	Liberated Black Dragon Egg	true
ancillaries_colour_text_vco_anc_enchanted_item_black_dragon_egg	In Ulthuan, the egg of a Dragon is sacred, and harsh punishment awaits any who endanger or disturb a Dragon nest. For the Vampires, a Dragon egg is naught but a potential source of power, and their nests nothing but cradles to nurture that power. This particular egg was liberated from the clutches of the Lahmian Sisterhood. Shackolot has vowed to raise it to maturity.	true
ancillaries_onscreen_name_vco_anc_enchanted_item_dragonfire_staff	Dragonfire Staff	true
ancillaries_colour_text_vco_anc_enchanted_item_dragonfire_staff	This gnarled staff of Helman's own design was carved from a rotten branch from the Haunted Forest. It is adorned with an ornate silver topper shaped like the head of a dragon, a powerful arcane artifact pillaged from a Cathayan caravan.	true
ancillaries_onscreen_name_vco_anc_arcane_item_eye_of_the_deep	Eye of the Deep	true
ancillaries_colour_text_vco_anc_arcane_item_eye_of_the_deep	An intricately crafted orb of unknown material that shimmers with an otherworldly light. Cylostra received it from a strange entity she encountered in the Underworld Sea.	true
ancillaries_onscreen_name_vco_anc_arcane_item_golden_lamp	Golden Lamp	true
ancillaries_colour_text_vco_anc_arcane_item_golden_lamp	While doing battle with Arabyan cultists, Henri and Repanse were set upon by a Fire-Djinn. Henri managed to outsmart the spirit by appealing to its pride, loudly declaring that it couldn't possibly contain its tempestuous form into so small a receptacle. The djinn was only too eager to prove Henri wrong, and shortly thereafter found itself imprisoned. Repanse sought to destroy it, but the Prophetesses persuaded her to stay her hand so that they can continue to study it.	true
ancillaries_onscreen_name_vco_anc_enchanted_item_the_crown_of_domination	The Crown of Domination	false
ancillaries_colour_text_vco_anc_enchanted_item_the_crown_of_domination	An ancient battle-helm dating back to the time of Morkar, it exudes an aura of raw malice to cow the servants of Chaos.	false
ancillaries_onscreen_name_vco_anc_arcane_item_vilitchs_locket	Vilitch's Locket	false
ancillaries_colour_text_vco_anc_arcane_item_vilitchs_locket	This ornate silver locket hangs around Archaon's neck at all times, threatening to throttle him at the slightest sign of disobedience. At times its filigreed surface slides open, revealing a blinking, living eye through which the Curseling sees all.	false
ancillaries_onscreen_name_vco_anc_weapon_blade_of_shadow	Blade of Shadow	false
ancillaries_colour_text_vco_anc_weapon_blade_of_shadow	A lesser blade forged from shadow magic siphoned from Be'lakor himself. Since the Godslayer spoke his True Name, he was incapable of resisting the act.	false
ancillaries_onscreen_name_vco_anc_weapon_shard_blade	Shard Blade	false
ancillaries_colour_text_vco_anc_weapon_shard_blade	The blade of Boris Ursus was crafted from the glaciers of Norsca and magically bound to remain forever frozen. When this mighty polearm strikes, the foe's blood turns to ice.	false
ancillaries_onscreen_name_vco_anc_weapon_gitsnik	Gitsnik	false
ancillaries_colour_text_vco_anc_weapon_gitsnik	This formidable axe came from the forges of Zharr Naggrund and, despite constant use, has never grown dull.	false
ancillaries_onscreen_name_vco_anc_armour_blood-forged_armour	Blood-Forged Armour	false
ancillaries_colour_text_vco_anc_armour_blood-forged_armour	After being forged under Red Eye Mountain, this armour was cooled with the blood of Dwarf Runesmiths.	false
ancillaries_onscreen_name_vco_anc_enchanted_item_cracked_rune_azamar	Cracked Rune of Azamar	false
ancillaries_colour_text_vco_anc_enchanted_item_cracked_rune_azamar	Though the Rune of Azamar's once flawless perfection is now marred by a single crack running down its centre, it still resonates with latent power. The rune was prised from the High King’s Throne of Power and now serves as an indisputable symbol of the conquest of Karaz-a-Karak.	false
ancillaries_onscreen_name_vco_anc_armour_dragonscale_cloak	Dragonscale Cloak	false
ancillaries_colour_text_vco_anc_armour_dragonscale_cloak	This cloak was fashioned from the flayed corpse of Zhao Ming, the Iron Dragon. Though it offers significant protection, it is heavily tainted by the corrupting influence of warpstone.\\n	false
ancillaries_onscreen_name_vco_anc_enchanted_item_writ_of_iron	Writ of Iron	false
ancillaries_colour_text_vco_anc_enchanted_item_writ_of_iron	A formal decree carved on flayed flesh, outlining Astragoth’s approval for immediate construction works to be undertaken by the bearer.	false
ancillaries_onscreen_name_vco_anc_arcane_item_blood_rune_bracers	Blood-Rune Bracers	false
ancillaries_colour_text_vco_anc_arcane_item_blood_rune_bracers	These obsidian bracers were forged from the daemonic essence of a Lord of Change. The blood-red runes glow with an eldritch power that grants the wielder control of their enemies’ fate.	false
ancillaries_onscreen_name_vco_anc_talisman_storm_dragons_heart	Dragon Heart	false
ancillaries_colour_text_vco_anc_talisman_storm_dragons_heart	This bloody organ was ripped from the corpse of the Storm Dragon by the victorious Dragonslayer Zhatan the Black. It crackles with barely contained energy, the Supreme Matriarch’s wrath lingering even in death.	false
ancillaries_onscreen_name_vco_anc_weapon_chittering_crossbow	Chittering Crossbow	false
ancillaries_colour_text_vco_anc_weapon_chittering_crossbow	This strange weapon fires daemonic bolts that cackle wildly as they speed towards the foe before exploding in a multicoloured fireball.	false
ancillaries_onscreen_name_vco_anc_weapon_staff_of_oblivion	Staff of Oblivion	false
ancillaries_colour_text_vco_anc_weapon_staff_of_oblivion	This bladed staff holds a glowing blue orb at its base which pulses with eldritch power. A skinless daemonic worm has wrapped itself around the orb and is leeching most of the orb’s energy, thus protecting the wielder from certain death.	false
ancillaries_onscreen_name_vco_anc_weapon_flensing_gauntlet	Flensing Gauntlet	false
ancillaries_colour_text_vco_anc_weapon_flensing_gauntlet	This metal gauntlet has hidden compartments across the knuckles that spring open to unleash a swarm of sorcerous wires which dart forth with a mind of their own to lacerate and entangle the foe.	false
ancillaries_onscreen_name_vco_anc_weapon_volcanic_morningstar	Volcanic Morningstar	false
ancillaries_colour_text_vco_anc_weapon_volcanic_morningstar	Fused in the molten core of Infernius, this morningstar shatters bone and ignites flesh with every swing.	false
ancillaries_onscreen_name_vco_anc_weapon_blissbarb_bow	Blissbarb Bow	false
ancillaries_colour_text_vco_anc_weapon_blissbarb_bow	Each serrated arrow is laced with toxins that renders the foe insensate - a willing victim for the unending cruelties to come.	false
ancillaries_onscreen_name_vco_anc_weapon_abyssal_whip	Abyssal Whip	false
ancillaries_colour_text_vco_anc_weapon_abyssal_whip	Allegedly made from the spine of an extinct breed of daemon, every lash of this whip flays flesh and exposes bone. Death comes slow for those exposed to its caresses.	false
ancillaries_onscreen_name_vco_wh_main_anc_weapon_axe_of_dargo	Axe of Dargo	false
ancillaries_colour_text_vco_wh_main_anc_weapon_axe_of_dargo	The Axe of Dargo, a runic weapon of monstrous size, is tempered with dragon's blood and oaths of vengeance.	false
ancillaries_onscreen_name_vco_anc_talisman_eight_pointed_star	The Eight-Pointed Star	false
ancillaries_colour_text_vco_anc_talisman_eight_pointed_star	This unholy talisman shudders with the power of no less than four bound Greater Daemons. The Daemonsmiths laboured for many weeks in the hell-forges to bring about its creation.	false
ancillaries_onscreen_name_vco_anc_talisman_mecha_arm	Mecha-Arm	false
ancillaries_colour_text_vco_anc_talisman_mecha_arm	Drazh-Zharr justice demanded Grimgor's hand be struck off for daring to raise it against his master. Yet Astragoth is prudent as well as just. He ensured his greatest Labourer was outfitted with a mechanical replacement.	false
ancillaries_onscreen_name_vco_anc_enchanted_item_chains_of_binding	Sorcerous Shackles	false
ancillaries_colour_text_vco_anc_enchanted_item_chains_of_binding	These chains radiate with Hashut's malign will and so subjugate Grimgor in perpetuity.	false
ancillaries_onscreen_name_vco_anc_enchanted_black_hammer_hashut_grimgor	The Black Hammer of Hashut	false
ancillaries_colour_text_vco_anc_enchanted_black_hammer_hashut_grimgor	This black-shafted hammer was taken from Astragoth's petrified corpse after his ultimate defeat at the hands of Grimgor Ironhide. It bears a horned rune of Hashut that glows with dark fire.	false
ancillaries_onscreen_name_vco_anc_talisman_hellshard_amulet_grimgor	Daemonspite Crucible	false
ancillaries_colour_text_vco_anc_talisman_hellshard_amulet_grimgor	Forged from meteoric iron and blighted gold, quenched in innocent blood and bound with slain, hell-bound souls, the Crucible is said to have been the handiwork of the ancient Chaos Dwarf Sorcerer Azgorh himself.	false
ancillaries_onscreen_name_vco_anc_enchanted_item_shadow_ruby	Shadow Ruby	false
ancillaries_colour_text_vco_anc_enchanted_item_shadow_ruby	Within this blood-red ruby swirls Be'lakor's ensnared soul. The daemon rages against the faceted walls of his prison, but there is no hope of escape.	false
ancillaries_onscreen_name_vco_anc_weapon_red_fang	Red Fang	false
ancillaries_colour_text_vco_anc_weapon_red_fang	This large, gore-drenched choppa once belonged to the legendary Orc Chieftan Gorfang Rotgut. The Squatter King met his end in a legendary duel against Malagor atop the battlements of Black Crag.	false
ancillaries_onscreen_name_vco_anc_weapon_tainted_blade_of_ptra	Tainted Blade of Ptra	false
ancillaries_colour_text_vco_anc_weapon_tainted_blade_of_ptra	This sword's white-hot edge is infused with the desert's baking heat, setting the air itself ablaze and blinding the foe.	false
ancillaries_onscreen_name_vco_anc_armour_armour_of_templehof	Armour of Templehof	false
ancillaries_colour_text_vco_anc_armour_armour_of_templehof	A product of twisted sorcery, this construct fuses with the wearer, giving him tremendous endurance.	false
ancillaries_onscreen_name_vco_anc_magic_standard_volkmar_banner	Jade Griffon Banner	false
ancillaries_colour_text_vco_anc_magic_standard_volkmar_banner	Even the faith of mighty Volkmar was sorely tested as he was taken up and chained to the battle standard of Malagor's warherd.	false
ancillaries_onscreen_name_vco_anc_weapon_profaned_sword_of_lyonesse	Profaned Sword of Lyonesse	false
ancillaries_colour_text_vco_anc_weapon_profaned_sword_of_lyonesse	Smeared in the blood and ash of its previous owner, this once holy blade now radiates with a fell power.	false
ancillaries_onscreen_name_vco_anc_enchanted_item_malagors_mask_of_heavens	Mask of Heavens	false
ancillaries_colour_text_vco_anc_enchanted_item_malagors_mask_of_heavens	The ancient magic of Tiktaq'to's mask is used by the Bray-Shamans to dominate the minds of the wilful Minotaurs.	false
ancillaries_onscreen_name_vco_anc_talisman_bloodstained_pendant	Bloodstained Pendant	false
ancillaries_colour_text_vco_anc_talisman_bloodstained_pendant	This ithilmar pendant, inset with a flawlessly carved brightstone, was gifted to Thorek Ironbrow by the High Loremaster Teclis as a gesture of peace and friendship.	false
ancillaries_onscreen_name_vco_anc_talisman_hunting_trophy	Hunting Trophy	false
ancillaries_colour_text_vco_anc_talisman_hunting_trophy	The Wanderer didn't wander far enough. His severed head now takes pride of place in the Huntsmarshal's trophy hall.	false
ancillaries_onscreen_name_vco_anc_enchanted_item_cursed_artifact_notidoq	Cursed Artifact of No'Tidoq	false
ancillaries_colour_text_vco_anc_enchanted_item_cursed_artifact_notidoq	This ancient artifact glows with an eldritch light, filling one's mind with a bestial fury.	false
ancillaries_onscreen_name_vco_anc_talisman_cracked_rune_azamar	Cracked Rune of Azamar	false
ancillaries_colour_text_vco_anc_talisman_cracked_rune_azamar	Though the Rune of Azamar's once flawless perfection is now marred by a single crack running down its centre, it still resonates with latent power. The rune was prised from the High King’s Throne of Power and now serves as an indisputable symbol of the Grand Chieftain's conquest.	false
ancillaries_onscreen_name_vco_anc_follower_fozzrik_summoner	Grey Seer Summoner	false
ancillaries_colour_text_vco_anc_follower_fozzrik_summoner	With a series of whispered words and intricate gestures, this Grey Seer can summon Fozzrik's Flying Fortress to the battlefield.	false
ancillaries_onscreen_name_vco_anc_follower_kemmler_black_grail_knight	Knight of the False Grail	false
ancillaries_colour_text_vco_anc_follower_kemmler_black_grail_knight	The Corpse King's damned knights ensure the Bretonnians remain complacent and productive.	false
ancillaries_onscreen_name_vco_anc_follower_dark_convent_defector	Dark Convent Defector	false
ancillaries_colour_text_vco_anc_follower_dark_convent_defector	Morathi's defeat bears treacherous fruit. This Sorceress has pledged herself to the Blood Queen's cause.	false
ancillaries_onscreen_name_vco_anc_weapon_kratchs_doomclaw	Kratch's Doomclaw	false
ancillaries_colour_text_vco_anc_weapon_kratchs_doomclaw	This crude, oversized warpstone-powered claw can easily slice through flesh and bone. It was taken from the corpse of Kratch Doomclaw, the previous ruler of Clan Rictus.	false
ancillaries_onscreen_name_vco_anc_armour_rictus_plate_armour	Rictus Plate Armour	false
ancillaries_colour_text_vco_anc_armour_rictus_plate_armour	This suit of plate armour is comprised entirely of warpstone. The chestpiece is engraved with Clan Rictus' symbol.	false
ancillaries_onscreen_name_vco_anc_talisman_lustrian_concoction	Lustrian Concoction	false
ancillaries_colour_text_vco_anc_talisman_lustrian_concoction	A potent mixture of extracted Itxi grub humours, crushed Jungle Lotus leaves and Coatl feathers grants the imbiber renewed vitality and an unparalleled mastery of the Winds of Magic... at least until the effects wear off.	false
ancillaries_onscreen_name_vco_anc_talisman_cathayan_concoction	Cathayan Concoction	false
ancillaries_colour_text_vco_anc_talisman_cathayan_concoction	A potent mixture of powdered Ki-rin horn, crushed Jade Lion teeth and Onyx Crowmen feathers grants the imbiber renewed vitality and an unparalleled mastery of the Winds of Magic... at least until the effects wear off.	false
ancillaries_onscreen_name_vco_anc_talisman_kemmler_black_arc	The Black Arc	false
ancillaries_colour_text_vco_anc_talisman_kemmler_black_arc	The Black Arc is a chunk of pure warpstone suspended in magical energy. To open the Arc is to unleash death upon the foe.	false
ancillaries_onscreen_name_vco_anc_enchanted_item_warpstone_stars	Warpstone Stars	false
ancillaries_colour_text_vco_anc_enchanted_item_warpstone_stars	These throwing weapons are coated with deadly poison that eats through armour and flesh.	false
ancillaries_onscreen_name_vco_anc_follower_war_mourner	War-Mourner of Karak Kadrin	false
ancillaries_colour_text_vco_anc_follower_war_mourner	Since Garagrim's death, Thrain Bloodbeard has taken his place as War-Mourner. It is the duty of the War-Mourner to act in the King's stead in battle, upholding his honour no matter the foe.	false
ancillaries_onscreen_name_vco_anc_weapon_axes_of_kadrin	Axes of Kadrin	false
ancillaries_colour_text_vco_anc_weapon_axes_of_kadrin	These runic axes once belonged to Garagrim Ironfist, gifted to him by his father upon his coming-of-age. Heavy chains bind them to the wielder's wrists, so they are never lost in the heat of battle.	false
ancillaries_onscreen_name_vco_anc_weapon_spear_of_daith	Spear of Daith	false
ancillaries_colour_text_vco_anc_weapon_spear_of_daith	Thalandor Doomstar, hopelessly corrupted by Drycha's fell influence, fought with this spear until he was slain by the Slayer King in single combat. Its hardwood shaft is carved with mystical spirals that give the weapon a will of its own.	false
ancillaries_onscreen_name_vco_anc_talisman_talisman_of_qwarr	Talisman of Qwarr	false
ancillaries_colour_text_vco_anc_talisman_talisman_of_qwarr	This ancient talon was given to the Slayer King by Thalandor Doomstar as a gesture of peace and thanks. It came from the mighty eagle, Qwarr, after its mortal battle with the ravenous dragon, Grathgol the Egg-Thief.	false
ancillaries_onscreen_name_vco_anc_follower_ice_vampire	Kattarin the Bloody	false
ancillaries_colour_text_vco_anc_follower_ice_vampire	Freed from her frozen prison and returned to unlife by the von Carsteins, Kattarin the Bloody now serves her dearest Isabella with undying loyalty, brutally massacring those Kislevites who still resist the new regime.	false
ancillaries_onscreen_name_vco_anc_weapon_wand_of_wych_elm	Wand of Wych Elm	false
ancillaries_colour_text_vco_anc_weapon_wand_of_wych_elm	This twisted and gnarled staff is cut from the rare and magical Wych Elm tree that draws magic from the ground beneath.	false
ancillaries_onscreen_name_vco_anc_weapon_warpsword_of_khaine_snikch	Warpsword of Khaine	false
ancillaries_colour_text_vco_anc_weapon_warpsword_of_khaine_snikch	This ancient blade glows with a heat hotter than any Dwarf furnace. It was looted from the ruined corpse of Malus Darkblade after his assassination.	false
ancillaries_onscreen_name_vco_anc_talisman_chameleon_cloak	Chameleon Cloak	false
ancillaries_colour_text_vco_anc_talisman_chameleon_cloak	The flayed hide of the Chameleon Skink Oxyotl constantly changes colour to match its surroundings.	false
ancillaries_onscreen_name_vco_anc_talisman_twilight_mask	Twilight Mask	false
ancillaries_colour_text_vco_anc_talisman_twilight_mask	Taken from the bodies of the Sisters of Twilight and fused together, the Mask of Twilight grants the wearer the ability to cheat death.	false
ancillaries_onscreen_name_vco_anc_follower_naieth_the_prophetess	Naieth the Prophetess	false
ancillaries_colour_text_vco_anc_follower_naieth_the_prophetess	Since the Heralds' victory over the vermin threat, Naieth the Prophetess has pledged herself to their cause. As a Spellweaver skilled in the art of divination, she is a valuable asset to any Asrai host.	false
ancillaries_onscreen_name_vco_anc_follower_lobotomised_warmbloods	Lobotomised Warmbloods	false
ancillaries_colour_text_vco_anc_follower_lobotomised_warmbloods	Under the guidance of Lord Chuqa-xi, the interlopers were lobotomised in an esoteric ritual at the City of the Moon, turning them into mindless, yet unflinchingly obedient, slave labourers.	false
ancillaries_onscreen_name_vco_anc_follower_priestess_of_isha	Priestess of Isha	false
ancillaries_colour_text_vco_anc_follower_priestess_of_isha	This representative of the Everqueen has committed herself to the daunting task of reintegrating Dark Elf defectors back into Ulthuani society.	false
ancillaries_onscreen_name_vco_anc_follower_shadowblade	Shadowblade	false
ancillaries_colour_text_vco_anc_follower_shadowblade	Only after Hellebron had claimed victory at Avelorn did Shadowblade emerge from the forests, his blades dripping with Asur blood. He stands ready to serve the Blood Queen once more.	false
ancillaries_onscreen_name_vco_anc_weapon_sacred_mace_of_quetzl	Sacred Mace of Quetzl	false
ancillaries_colour_text_vco_anc_weapon_sacred_mace_of_quetzl	After Nakai's victory over the interlopers at Itza, Lord Mazdamundi imbued Nakai's weapon with mystic power. It has attained an almost sentient awareness, often drawing Nakai's hands to his targets or blocking blows the ancient beast was unaware of.	false
ancillaries_onscreen_name_vco_anc_talisman_amulet_of_sunfire	Amulet of Sunfire	false
ancillaries_colour_text_vco_anc_talisman_amulet_of_sunfire	The radiant aura of this amulet provides hope to those in despair and wards against evil creatures.	false
ancillaries_onscreen_name_vco_anc_weapon_alith_destroyer	Destroyer	false
ancillaries_colour_text_vco_anc_weapon_alith_destroyer	This dread blade once belonged to the Witch King before his assassination. Its merest touch can unmake enchantments and wither minds.	false
ancillaries_onscreen_name_vco_anc_follower_haurg_frostmaw	Haurg Frostmaw	false
ancillaries_colour_text_vco_anc_follower_haurg_frostmaw	This Yhette has wandered down from the highest slopes of the Mountains of Mourn to join Throgg's Monstrous Horde.	false
ancillaries_onscreen_name_vco_anc_follower_grey_dwarf	Grey Dwarf Diplomat	false
ancillaries_colour_text_vco_anc_follower_grey_dwarf	This Dwarf has had many dealings with the manlings and is well-placed in both Imperial and Bretonnian courts.	false
ancillaries_onscreen_name_vco_anc_magic_standard_belegar_banner	Angrund's Triumph	false
ancillaries_colour_text_vco_anc_magic_standard_belegar_banner	Clan Angrund's royal standard now sports the severed heads of Skarsnik and Queek Headtaker, slain in single combat by the one true king of Karak Eight Peaks.	false
ancillaries_onscreen_name_vco_anc_weapon_the_hammer_of_angrund	The Hammer of Angrund	false
ancillaries_colour_text_vco_anc_weapon_the_hammer_of_angrund	Soaked in centuries of Greenskin blood, the Ironhammer has been handed down to every rightful Angrund ruler of the Eight Peaks. When Belegar Ironhammer was slain in the War for the Eight Peaks, the hammer was taken as a trophy by Warlord Skarsnik.	false
ancillaries_onscreen_name_vco_anc_weapon_dwarf_gouger	Dwarf Gouger	false
ancillaries_colour_text_vco_anc_weapon_dwarf_gouger	This wicked and ancient Skaven weapon was fashioned as the Skaven battled to wrest the Worlds Edge Mountains from the Dwarfs. It was taken from Queek Headtaker's corpse after he was slain by Warlord Skarsnik during the War for the Eight Peaks.	false
ancillaries_onscreen_name_vco_anc_weapon_chd_dagger_of_malice	Dagger of Malice	false
ancillaries_colour_text_vco_anc_weapon_chd_dagger_of_malice	This blade whispers thoughts of murder and violence to any that grasp its hilt, and remains gleaming, no matter how much bloody work it has done.	false
ancillaries_onscreen_name_vco_anc_follower_eye_of_rage	The Blazing Eye	false
ancillaries_colour_text_vco_anc_follower_eye_of_rage	This bright blue orb burns with the bottomless rage of the humbled daemon, Skarbrand the Exiled One.	false
ancillaries_onscreen_name_vco_anc_follower_settras_head	Settra’s Head	false
ancillaries_colour_text_vco_anc_follower_settras_head	The King of Kings vacillates between lamenting his eternal humiliation and berating Queek for his insolence, depending on his mood.	false
ancillaries_onscreen_name_vco_anc_follower_crowfathers_wings	The Crowfather’s Wings	false
ancillaries_colour_text_vco_anc_follower_crowfathers_wings	Though they were severed from the Harbinger's corpse long ago, these jet-black wings sporadically burst into a flurry of movement for no apparent reason.	false
ancillaries_onscreen_name_vco_anc_follower_jade_griffon	Jade Griffon	false
ancillaries_colour_text_vco_anc_follower_jade_griffon	Queek's excitement quickly turned to rage when he discovered the man-thing's glowing green trinket was not, in fact, warpstone.	false
ancillaries_onscreen_name_vco_anc_follower_damsels_ashes	The Damsel’s Ashes	false
ancillaries_colour_text_vco_anc_follower_damsels_ashes	In hindsight, a valiant cavalry charge directly towards a rank of Warpfire Throwers was not the best idea. These irradiated ashes were all that remained for Queek to harvest as a trophy.	false
ancillaries_onscreen_name_vco_anc_follower_belegars_head	Belegar’s Head	false
ancillaries_colour_text_vco_anc_follower_belegars_head	The Exile King takes pride of place upon Queek's trophy rack, though his monotonous grumbling is a source of constant irritation for the Skaven Warlord.	false
ancillaries_onscreen_name_vco_anc_follower_skarsniks_head	Skarsnik’s Head	false
ancillaries_colour_text_vco_anc_follower_skarsniks_head	In death, the Night Goblin Warlord has proven himself a valuable ally. His cunning schemes are often too convoluted for the Headtaker to fully grasp, but their fruition brings undeniable results.	false
ancillaries_onscreen_name_vco_anc_enchanted_item_withering_orb	Withering Idol	false
ancillaries_colour_text_vco_anc_enchanted_item_withering_orb	With the proper application of warpstone, this ancient artefact will unfurl like the petals of some eldritch flower and loose death upon the foe.	false
ancillaries_onscreen_name_vco_anc_follower_ska_bloodtail	Ska Bloodtail	false
ancillaries_colour_text_vco_anc_follower_ska_bloodtail	Right paw to Queek Headtaker and Fangleader of the Red Guard, what Ska Bloodtail lacks in intelligence he makes up for in unwavering loyalty and a near-suicidal fearlessness.\\n	false
ancillaries_onscreen_name_vco_anc_weapon_carmine_axe_eight_peaks	The Carmine Axe of Vala-Azril-Ungol	false
ancillaries_colour_text_vco_anc_weapon_carmine_axe_eight_peaks	This axe was forged in Karak Eight Peaks by the mad Runesmith Orrey Singebeard. The Skaven know it as the Red Death, and Night Goblins typically lose control of their bowels at the mere sight of it.	false
ancillaries_onscreen_name_vco_anc_follower_graven_idol	Graven Idol	false
ancillaries_colour_text_vco_anc_follower_graven_idol	Astragoth’s petrified remains still glow like the dying embers of a forge. The aged priest's waning magics were no match for Tz'arkan's might.	false
ancillaries_onscreen_name_vco_anc_follower_ruby_lahmia	Ruby of Lahmia	false
ancillaries_colour_text_vco_anc_follower_ruby_lahmia	Neferata’s golden diadem is all that remains of the Queen of the Silver Pinnacle. It is inset with a blood-red ruby that pulses with the power of eternal life.	false
ancillaries_onscreen_name_vco_anc_follower_dammaz_kron	The Dammaz Kron	false
ancillaries_colour_text_vco_anc_follower_dammaz_kron	This tedious tome was prised from the High King's cold, dead hands. It lists every grievance ever inflicted on their stunted kind. The last page is incomplete and spattered with blood.	false
ancillaries_onscreen_name_vco_anc_follower_minaithnirs_skull	Minaithnir's Skull	false
ancillaries_colour_text_vco_anc_follower_minaithnirs_skull	The great dragon’s skull is an impressive sight, effortlessly dominating any chamber where it is displayed. The ancient beast was brought low by a battery of Reaper Bolt Throwers.	false
ancillaries_onscreen_name_vco_anc_follower_golden_mawtooth	Golden Mawtooth	false
ancillaries_colour_text_vco_anc_follower_golden_mawtooth	One of an Ogre tribe’s most valued items is its Mawtooth, typically a stone that bears the tribe’s scrawled marks and sigils. Ever given to ostentatious displays, the Goldtooth tribe’s Mawtooth is made of solid gold. It is a gleaming symbol of Malus’ conquests in the Ogre Kingdoms.	false
