key	text	tooltip
#Loc;1;text/db/vco_cdir_events_dilemma_choice_details.loc		
cdir_events_dilemma_choice_details_localised_choice_label_vco_brt_alb_dilemma_mananns_favourFIRST	Pray for Storms	true
cdir_events_dilemma_choice_details_localised_choice_label_vco_brt_alb_dilemma_mananns_favourSECOND	Pray for Calm Seas	true
cdir_events_dilemma_choice_details_localised_choice_label_vco_chs_arc_dilemma_slayer_kingsFIRST	Free the Daemon	false
cdir_events_dilemma_choice_details_localised_choice_label_vco_chs_arc_dilemma_slayer_kingsSECOND	Deny the Daemon	false
cdir_events_dilemma_choice_details_localised_choice_label_vco_cth_miao_dilemma_sister_rescuedFIRST	Counsel Temperance	true
cdir_events_dilemma_choice_details_localised_choice_label_vco_cth_miao_dilemma_sister_rescuedSECOND	Counsel Vengeance	true
cdir_events_dilemma_choice_details_localised_choice_label_vco_dwf_gro_dilemma_elvesFIRST	Forgive the Elves	true
cdir_events_dilemma_choice_details_localised_choice_label_vco_dwf_gro_dilemma_elvesSECOND	Condemn the Elves	true
cdir_events_dilemma_choice_details_localised_choice_label_vco_ksl_kat_dilemma_call_for_aidFIRST	Petition the Bretonnians	true
cdir_events_dilemma_choice_details_localised_choice_label_vco_ksl_kat_dilemma_call_for_aidFOURTH	Petition the High Elves	true
cdir_events_dilemma_choice_details_localised_choice_label_vco_ksl_kat_dilemma_call_for_aidSECOND	Petition the Dwarfs	true
cdir_events_dilemma_choice_details_localised_choice_label_vco_ksl_kat_dilemma_call_for_aidTHIRD	Petition the Empire	true
cdir_events_dilemma_choice_details_localised_choice_label_vco_skv_mdr_dilemma_ultimate_harvestFIRST	Devour the Godflesh	true
cdir_events_dilemma_choice_details_localised_choice_label_vco_skv_mdr_dilemma_ultimate_harvestSECOND	Trade the Godflesh	true
cdir_events_dilemma_choice_details_localised_choice_label_vco_vmp_man_dilemma_ossified_portalFIRST	Cross the Threshold	false
cdir_events_dilemma_choice_details_localised_choice_label_vco_vmp_man_dilemma_ossified_portalSECOND	The Time Is Not Right	false
cdir_events_dilemma_choice_details_localised_choice_label_vco_vmp_man_dilemma_ossified_portalTHIRD	I Care Not	false
cdir_events_dilemma_choice_details_localised_choice_title_vco_brt_alb_dilemma_mananns_favourFIRST	Alberic offers his trident up to his god, vowing that he will continue to hunt Manann's enemies wherever the storms rage the hardest.	true
cdir_events_dilemma_choice_details_localised_choice_title_vco_brt_alb_dilemma_mananns_favourSECOND	Falling to one knee, Alberic humbles himself before his god and prays for the safe passage of Bretonnia's fleets.	true
cdir_events_dilemma_choice_details_localised_choice_title_vco_chs_arc_dilemma_slayer_kingsFIRST	“You are free, daemon. Free to serve as my pack mule. Now go, search the corpses of the slain. Bring back anything of value you find.”	false
cdir_events_dilemma_choice_details_localised_choice_title_vco_chs_arc_dilemma_slayer_kingsSECOND	“I said I would set you free, mighty daemon. I never said when.”	false
cdir_events_dilemma_choice_details_localised_choice_title_vco_cth_miao_dilemma_sister_rescuedFIRST	Come sister, you have suffered enough in these foul wastes. Travel with me to the Paradise Gardens. Mother will be overjoyed at your return.	true
cdir_events_dilemma_choice_details_localised_choice_title_vco_cth_miao_dilemma_sister_rescuedSECOND	These foul daemons must pay for their transgressions! Fight alongside me, sister. Together, we will push them back to the very polar gates!	true
cdir_events_dilemma_choice_details_localised_choice_title_vco_dwf_gro_dilemma_elvesFIRST	The Grudge is struck. The Witch King's veiled machinations have been laid bare for all to see. Let us reforge the old alliances and stand together as one against the coming darkness.	true
cdir_events_dilemma_choice_details_localised_choice_title_vco_dwf_gro_dilemma_elvesSECOND	Malekith proved that the Elgi cannot be trusted. It is in their nature to lie and decieve, and the Dawi would be fools to forget this. The War of Vengeance will begin anew, and this time it will not end until we have their unconditional surrender. Muster the throngs - we march to Ulthuan!	true
cdir_events_dilemma_choice_details_localised_choice_title_vco_ksl_kat_dilemma_call_for_aidFIRST	The knights of fair Bretonnia are far removed from the grim troubles of the north, but they are ever hungry for glory and would surely jump at this chance to prove their valour. 	true
cdir_events_dilemma_choice_details_localised_choice_title_vco_ksl_kat_dilemma_call_for_aidFOURTH	The Elves of distant Ulthuan once came to Kislev's aid in her darkest hour. That time has come again. Though they are enamoured in a civil war that has lasted centuries, they may be willing to fight alongside us once more.	true
cdir_events_dilemma_choice_details_localised_choice_title_vco_ksl_kat_dilemma_call_for_aidSECOND	The Slayer King of Karak Kadrin is unlikely to march to our defence while his own hold is under constant assault from Greenskins and Vampires, but his death-seeking Slayers may be lured to our cause if we insist our situation is one of imminent doom.	true
cdir_events_dilemma_choice_details_localised_choice_title_vco_ksl_kat_dilemma_call_for_aidTHIRD	We are the shield of the Empire, all that stands between them and the vast legions of Chaos. The squabbling Elector Counts would do well to remember that. It is in their mutual interest to lend us their support.	true
cdir_events_dilemma_choice_details_localised_choice_title_vco_skv_mdr_dilemma_ultimate_harvestFIRST	For long years, Throt's every thought, every deed, has been dominated by gnawing hunger. As the Mage-Queen's divine pulp reaches his broiling gut, his mind clears and turns immediately to the next foul experiment. Of the forests and those within, Throt cares not. Let Chaos take them.	true
cdir_events_dilemma_choice_details_localised_choice_title_vco_skv_mdr_dilemma_ultimate_harvestSECOND	As the Mage-Queen's divine pulp bubbles merrily in the cauldron, Throt considers whether hoarding the godflesh is in his clan's best interests. Surely other clans would pay a king's ransom to have even a single vial of the precious liquid...	true
cdir_events_dilemma_choice_details_localised_choice_title_vco_vmp_man_dilemma_ossified_portalFIRST	I must return to Castle Drakenhof and study these books further. My sire will surely relinquish his claim once he witnesses my newfound power. If not... then he will suffer the same fate as the Devils of Swartzhafen.	false
cdir_events_dilemma_choice_details_localised_choice_title_vco_vmp_man_dilemma_ossified_portalSECOND	These dunes still hide many treasures. My business is not concluded here.	false
cdir_events_dilemma_choice_details_localised_choice_title_vco_vmp_man_dilemma_ossified_portalTHIRD	Sylvania is presently of no concern. I must focus my efforts elsewhere.	false
cdir_events_dilemma_choice_details_localised_choice_label_vco_chs_aza_dilemma_supplicants_comeFIRST	Khazrak the One-Eye	true
cdir_events_dilemma_choice_details_localised_choice_label_vco_chs_aza_dilemma_supplicants_comeSECOND	The King of Bretonnia	true
cdir_events_dilemma_choice_details_localised_choice_label_vco_chs_aza_dilemma_supplicants_comeTHIRD	The Briarmaven of Woe	true
cdir_events_dilemma_choice_details_localised_choice_label_vco_chs_aza_dilemma_supplicants_comeFOURTH	The Ice Queen	true
cdir_events_dilemma_choice_details_localised_choice_title_vco_chs_aza_dilemma_supplicants_comeFIRST	This Beastlord brays loudly for all to hear. It is a sound of primal lust, a promise of many nights of rutting soon to come.	true
cdir_events_dilemma_choice_details_localised_choice_title_vco_chs_aza_dilemma_supplicants_comeSECOND	The Bretonnian begs you to strike off his head with his own blade, utterly convinced of the justification of the act.	true
cdir_events_dilemma_choice_details_localised_choice_title_vco_chs_aza_dilemma_supplicants_comeTHIRD	A Dryad of the forests kneels before you, guised in the alluring form of a beautiful, lithe elf-maiden. It is said her skills of seduction rival even those of your own...	true
cdir_events_dilemma_choice_details_localised_choice_title_vco_chs_aza_dilemma_supplicants_comeFOURTH	Kislev's Tzarina promises a night of wonder within her Ice Palace. She asks only that you grant her an heir.	true
cdir_events_dilemma_choice_details_localised_choice_label_vco_chs_fes_dilemma_lustrian_plagueFIRST	Befoul the Waters	true
cdir_events_dilemma_choice_details_localised_choice_label_vco_chs_fes_dilemma_lustrian_plagueSECOND	Taint the Air	true
cdir_events_dilemma_choice_details_localised_choice_title_vco_chs_fes_dilemma_lustrian_plagueFIRST	Dump the contents of the Cauldron of a Thousand Poxes into the River Reik. The contagion will flow across the Empire, bringing death and misery to many.	true
cdir_events_dilemma_choice_details_localised_choice_title_vco_chs_fes_dilemma_lustrian_plagueSECOND	Stoke the Plague Furnaces deep beneath their cities. The tainted air will waft up from the sewers, rendering the largest population centres almost uninhabitable.	true
cdir_events_dilemma_choice_details_localised_choice_label_vco_chs_vil_dilemma_the_reckoningFIRST	Break His Mind	true
cdir_events_dilemma_choice_details_localised_choice_label_vco_chs_vil_dilemma_the_reckoningSECOND	Bind His Body	true
cdir_events_dilemma_choice_details_localised_choice_title_vco_chs_vil_dilemma_the_reckoningFIRST	Shatter Archaon's mind, leaving him as little more than a gibbering automaton who will wordlessly obey Vilitch's every command.	true
cdir_events_dilemma_choice_details_localised_choice_title_vco_chs_vil_dilemma_the_reckoningSECOND	Carve his flesh with Tzeentchian runes of binding. His mind will remain intact, but he will be trapped within a body that answers only to the Curseling.	true
cdir_events_dilemma_choice_details_localised_choice_label_vco_chs_val_dilemma_nkari_approachesFIRST	Cut Off His Head	true
cdir_events_dilemma_choice_details_localised_choice_label_vco_chs_val_dilemma_nkari_approachesSECOND	Rip Out His Heart	true
cdir_events_dilemma_choice_details_localised_choice_title_vco_chs_val_dilemma_nkari_approachesFIRST	With one deft blow, Valkia parts N'Kari's head from his shoulders. His skull will surely make a worthy offering to Khorne!	true
cdir_events_dilemma_choice_details_localised_choice_title_vco_chs_val_dilemma_nkari_approachesSECOND	The Spear Slaupnir sings out, deftly plucking N'kari's heart from his chest. Valkia smiles as she bites into it, relishing the Greater Daemon's stolen strength.	true
cdir_events_dilemma_choice_details_localised_choice_label_vco_vmp_hel_dilemma_dark_bargainFIRST	Accept the Bargain	true
cdir_events_dilemma_choice_details_localised_choice_label_vco_vmp_hel_dilemma_dark_bargainSECOND	Reject the Bargain	true
cdir_events_dilemma_choice_details_localised_choice_title_vco_vmp_hel_dilemma_dark_bargainFIRST	Tears welling in his eyes, Helman abandons his quest, and farewells his brothers for what he knows is the last time. The Darkforged Vessel shatters, and the daemonic entity nestles itself within its new mortal shell.	true
cdir_events_dilemma_choice_details_localised_choice_title_vco_vmp_hel_dilemma_dark_bargainSECOND	“You lie, daemon! My brothers would never forsake me!”	true
cdir_events_dilemma_choice_details_localised_choice_label_vco_cst_cyl_dilemma_finest_hourFIRST	The Folly of Malekith	true
cdir_events_dilemma_choice_details_localised_choice_label_vco_cst_cyl_dilemma_finest_hourSECOND	Garamont's Triumph	true
cdir_events_dilemma_choice_details_localised_choice_label_vco_cst_cyl_dilemma_finest_hourTHIRD	Finubar's Lament	true
cdir_events_dilemma_choice_details_localised_choice_label_vco_cst_cyl_dilemma_finest_hourFOURTH	The Tale of Cylostra	true
cdir_events_dilemma_choice_details_localised_choice_title_vco_cst_cyl_dilemma_finest_hourFIRST	A comic opera depicting Malekith's disastrous attempt to walk into the Flame of Asuryan. It will surely have her audience doubled over in fits of laughter!	true
cdir_events_dilemma_choice_details_localised_choice_title_vco_cst_cyl_dilemma_finest_hourSECOND	This song was very popular in Cylostra's homeland of Bretonnia. It is a tale of triumph depicting Calarad of Garamont's victory over the fallen knight Merovech of Mousillon.	true
cdir_events_dilemma_choice_details_localised_choice_title_vco_cst_cyl_dilemma_finest_hourTHIRD	A sorrowful tale about an Everqueen's unfaithful heart. Cylostra sings it so beautifully that even the fish begin to weep.	true
cdir_events_dilemma_choice_details_localised_choice_title_vco_cst_cyl_dilemma_finest_hourFOURTH	A grand operatic performance complete with elaborate sets, costumed zombies, and even a cameo appearance by Cymbals, Cylostra's pet monkey.	true
cdir_events_dilemma_choice_details_localised_choice_label_vco_brt_rep_dilemma_eternal_warFIRST	The Southlands Crusade	true
cdir_events_dilemma_choice_details_localised_choice_label_vco_brt_rep_dilemma_eternal_warSECOND	The Badlands Crusade	true
cdir_events_dilemma_choice_details_localised_choice_title_vco_brt_rep_dilemma_eternal_warFIRST	Repanse raises her sword to the sky and declares that the Chevaliers de Lyonesse shall march south, into the sweltering jungles of the Southlands. The peasants whisper prayers and hold their trinkets close, for these lands are strongly reminiscent of Athel Loren back home.	true
cdir_events_dilemma_choice_details_localised_choice_title_vco_brt_rep_dilemma_eternal_warSECOND	Repanse levels her holy blade to the north, in the direction of the Badlands. The Bretonnians are no strangers to the Greenskins. A chance to strike at their homeland has them chomping at the bit.	true
